{
  "version": 1,
  "data": {
    "tilesetPath": "maps/ambient/local/textures/environment/city/environment-city.png",
    "tileSize": 132,
    "displaySize": 32,
    "collidableTiles": [0,5,25],
    "data": [
      [ 25, 25, 25, 25, 25, 25, 25, 25, 25, 25, 25, 25, 25, 25, 25 ],
      [ 25, 95, 95, 95, 95, 95, 95, 95, 95, 95, 95, 95, 95, 95, 25 ],
      [ 25, 95, 25, 95, 95, 95, 95, 95, 95, 95, 95, 95, 95, 95, 25 ],
      [ 25, 95, 25, 25, 95, 95, 95, 95, 95, 95, 95, 95, 95, 95, 25 ],
      [ 25, 95, 95, 95, 95, 95, 95, 95, 95, 95, 95, 95, 95, 95, 25 ],
      [ 25, 95, 95, 95, 95, 95, 95, 95, 95, 95, 95, 95, 95, 95, 25 ],
      [ 25, 95, 95, 95, 95, 95, 95, 95, 95, 95, 95, 95, 95, 95, 25 ],
      [ 25, 95, 95, 95, 95, 95, 95, 95, 95, 95, 95, 95, 95, 95, 25 ],
      [ 25, 95, 95, 95, 95, 95, 95, 95, 95, 95, 95, 95, 95, 95, 25 ],
      [ 25, 95, 95, 95, 95, 95, 95, 95, 95, 95, 95, 95, 95, 95, 25 ],
      [ 25, 95, 95, 95, 95, 95, 25, 25, 25, 95, 95, 95, 95, 95, 25 ],
      [ 25, 95, 95, 95, 95, 95, 95, 95, 95, 95, 95, 95, 95, 95, 25 ],
      [ 25, 95, 95, 95, 95, 95, 95, 95, 95, 95, 95, 95, 95, 95, 25 ],
      [ 25, 95, 95, 95, 95, 95, 95, 95, 95, 95, 95, 95, 95, 95, 25 ],
      [ 25, 25, 25, 25, 25, 25, 25, 25, 25, 25, 25, 25, 25, 25, 25 ]
    ]
  }
}