{
  "version": 1,
  "data": {
    "tilesetPath": "maps/shooting/local/textures/environment/city/environment-city.png",
    "tileSize": 132,
    "displaySize": 32,
    "collidableTiles": [ 5, 25],
    "data": [
      [ 25, 25, 25, 25, 25, 25, 25, 25, 25, 25, 25, 25, 25, 25, 25, 25, 25, 25, 25, 25, 25, 25, 25, 25, 25, 25, 25, 25, 25, 25 ],
      [ 25,295,295,295,295,295,295,295,295,295,295,295,295,295,295,295,295,295,295,295,295,295,295,295,295,295,295,295,295, 25 ],
      [ 25,295,295,295,295,295,295,295,295,295,295,295,295,295,295,295,295,295,295,295,295,295,295,295,295,295,295,295,295, 25 ],
      [ 25,295,295,5,5,5,5,5,295,295,295,295,295,295,295,295,295,295,295,295,295,295,295,295,295,295,295,295,295, 25 ],
      [ 25,295,295,5,295,295,295,5,295,295,295,295,295,295,295,295,295,295,295,295,295,295,295,295,295,295,295,295,295, 25 ],
      [ 25,295,295,5,295,295,295,5,295,295,295,295,295,295,295,295,295,295,295,295,295,295,295,295,295,295,295,295,295, 25 ],
      [ 25,295,295,5,5,295,5,5,295,295,295,295,295,295,295,295,295,295,295,295,295,295,295,295,295,295,295,295,295, 25 ],
      [ 25,295,295,295,295,295,295,295,295,295,295,295,295,295,295,295,295,295,295,295,295,295,295,295,295,295,295,295,295, 25 ],
      [ 25,295,295,295,295,295,295,295,295,295,295,295,295,295,295,295,295,295,295,295,295,295,295,295,295,295,295,295,295, 25 ],
      [ 25,295,295,295,295,295,295,295,295,295,295,295,295,295,295,295,295,295,295,295,295,295,295,295,295,295,295,295,295, 25 ],
      [ 25,295,295,295,295,295,295,295,295,295,295,295,295,295,295,295,295,295,295,295,295,295,295,295,295,295,295,295,295, 25 ],
      [ 25,295,295,295,295,295,295,295,295,295,295,295,295,295,295,295,295,295,295,295,295,295,295,295,295,295,295,295,295, 25 ],
      [ 25,295,295,295,295,295,295,295,295,295,295,295,295,295,295,295,295,295,295,295,295,295,295,295,295,295,295,295,295, 25 ],
      [ 25,295,295,295,295,295,295,295,295,295,295,295,295,295,295,295,295,295,295,295,295,295,295,295,295,295,295,295,295, 25 ],
      [ 25,295,295,295,295,295,295,295,295,295,295,295,295,295,295,295,295,295,295,295,295,295,295,295,295,295,295,295,295, 25 ],
      [ 25,295,295,295,295,295, 25, 25, 25, 25, 25, 25, 25, 25, 25, 25, 25,295,295,295,295,295,295,295,295,295,295,295,295, 25 ],
      [ 25,295,295,295,295,295, 25,295,295,295,295,295,295,295,295,295,295, 25,295,295,295,295,295,295,295,295,295,295,295, 25 ],
      [ 25,295,295,295,295,295, 25,295,295,295,295,295,295,295,295,295,295, 25,295,295,295,295,295,295,295,295,295,295,295, 25 ],
      [ 25,295,295,295,295,295, 25,295,295,295,295,295,295,295,295,295,295, 25,295,295,295,295,295,295,295,295,295,295,295, 25 ],
      [ 25,295,295,295,295,295, 25,295,295,295,295,295,295,295,295,295,295, 25,295,295,295,295,295,295,295,295,295,295,295, 25 ],
      [ 25,295,295,295,295,295, 25,295,295,295,295,295,295,295,295,295,295, 25,295,295,295,295,295,295,295,295,295,295,295, 25 ],
      [ 25,295,295,295,295,295, 25,295,295,295,295,295,295,295,295,295,295, 25,295,295,295,295,295,295,295,295,295,295,295, 25 ],
      [ 25,295,295,295,295,295, 25,295,295,295,295,295,295,295,295,295,295, 25,295,295,295,295,295,295,295,295,295,295,295, 25 ],
      [ 25,295,295,295,295,295, 25, 25, 25,295,295, 25, 25, 25, 25, 25, 25, 25,295,295,295,295,295,295,295,295,295,295,295, 25 ],
      [ 25,295,295,295,295,295,295,295,295,295,295,295,295,295,295,295,295,295,295,295,295,295,295,295,295,295,295,295,295, 25 ],
      [ 25,295,295,295,295,295,295,295,295,295,295,295,295,295,295,295,295,295,295,295,295,295,295,295,295,295,295,295,295, 25 ],
      [ 25,295,295,295,295,295,295,295,295,295,295,295,295,295,295,295,295,295,295,295,295,295,295,295,295,295,295,295,295, 25 ],
      [ 25,295,295,295,295,295,295,295,295,295,295,295,295,295,295,295,295,295,295,295,295,295,295,295,295,295,295,295,295, 25 ],
      [ 25,295,295,295,295,295,295,295,295,295,295,295,295,295,295,295,295,295,295,295,295,295,295,295,295,295,295,295,295, 25 ],
      [ 25, 25, 25, 25, 25, 25, 25, 25, 25, 25, 25, 25, 25, 25, 25, 25, 25, 25, 25, 25, 25, 25, 25, 25, 25, 25, 25, 25, 25, 25 ]
    ]
  }
}
